#############################################################################################################################################
#...........#####...#######...#####################.............#...........#...#####...###...#.......###.....#####...#.....#.........#....E#
#.#########.#####.#.#######.#.#####################.#.#########.#.#.#######.#.#.#####.#.###.#.#.#####.###.###.#####.#.#.###.#.#######.#.###.#
#.............#...#.........#...#################...#.#########...#.#.....#...#.......#...#.........#.###...#.......#...#...#...#####.#...#.#
#########.###.#.###########.###.#################.###.###########.#.#.###.###########.###.#.#######.#.#####.###########.#.###.#.#####.#.#.#.#
#.......#.#...#...###...###.###.#######...#######...#.###########.#.#.....................#.....#...#...................#...#.#.#####.#.#.#.#
#.#####.#.#.#####.###.#.###.###.#######.#.#########.#.###########.#.#.#.###.###.#.#.#.#.#.#####.#.#######.#.#.#####.#.#.###.#.#.#####.#.#.#.#
#...###...#.#####.....#.###...#...#.....#...........#.###########.#.#.#.###...#.#.#.#.#...#####.#.#####...#.#.#####...#.###.#.#...#...#.#.#.#
###.#######.#######.#.#.###.#.###.#.#################.###########.#.#.#.#####.#.#.#.#.#########.#.#####.###.#.#########.###.#.###.#.###.#.#.#
###...#####.#####...#.#.............#...#####.......#.###########...#...#.....#.#...#.......#...#...#...#...#.....#.........................#
#####.#####.#####.#.#.#.#.#.#.#.#####.#.#####.#####.#.###########.#####.#.###.#.#####.###.#.#.#####.#.###.###.###.#.###.#.#####.#############
#####.###...#.....#.....#.#...#.#.....#.......#####.#...#######...#####.........#####.....#...###...#.#...........#.#.....#####.#######...###
#####.###.###.#######.###.#####.#.#################.###.#######.#.#######.#####.#####.###########.#.#.#.#####.#####.#.#########.#######.#.###
#.....###.#...#######.....#####...#.........###.....#...#######.#.....###...###.###...###...#####.....................###.......#####...#...#
#.#######.#.#.#######.#.###########.#######.###.#####.#########.#####.#####.###.###.#.###.#.#####.###.#.#####.#######.###.###########.#####.#
#...#####.#.#...###...#.#.......###.###...#.#...#####.#########.#####.....#...#.....#.....#.#####...#.#...#...#####...#...#...#######.#####.#
###.#####.#.###.###.#.#.#.#####.###.###.#.#.#.#######.#########.#######.#.###.#######.#####.#######.#.###.#.#######.###.###.#.#######.#####.#
###.#####.#.#...###.#...#.#####.....###.#...#.....#...#########.#######.........#####.#####.###.....#.###.#.....###...#.....#.#.......#####.#
###.#####.#.#.#####.#####.#############.###.#####.#.###########.###############.#####.#####.###.#####.###.#.###.#####.#######.#.###########.#
###.###...#.#...#...#.....#...###...###.###.#####...###.........#######...#...#.#####.###...###...###...#.#...#.#####.#.......#.....#.......#
###.###.###.###.#.###.#####.#.###.#.###.###.###########.###############.#.#.#.#.#####.###.#######.#####.#.###.#.#####.#.###########.#.#####.#
#...###.###.#...#.....#...#.#.....#.....#...###########.#...###########.#...#.#.#####.###...#...#.#####.#...#.#...###.#.###.........#.....#.#
#.#####.###.#.#########.#.#.#############.#############.#.#.###########.#####.#.#####.#####.#.#.#.#####.###.#.###.###.#.###.#############.#.#
#.....#.......#.........#.#.#.....#######.#...#########...#...#########...#...#...###.....#...#...#####...#.#...#.....#.###.......#######...#
#####.#####.###.#########.#.#.###.#######.#.#.###############.###########.#.#####.#######.#######.#######.#.###.#######.#########.#######.###
#.....###...............#.#.#.#...#####...#...###.........#...#########...#.###...###...#.#.......###...#...###...#.......#######.....#...###
#.#######.#.###.#.#####.#.#.#.#.#######.###.#.###.#######.#.###########.###.###.#####.#.#.#.#####.###.#.#########.#.#####.###########.#.#####
#...#####.#...#.#.#####.#.#.#.#.#######.#...#...#.....###...#.......###.#...###...###.#...#.....#.###.#.......#.....###...###########.#.....#
###.#####.#.#.#.#.#####.#.#.#.#.#######.#.#.###.#####.#######.#####.###.#.#######.###.#########.#.###.#######.#.#######.#############.#####.#
#...#...#...#.#.#.#...#.#...#.#.#######.#.....#...###.#######.#####.#...#.....###.###.......###.#.#...#######.........#.....#...............#
#.###.#.###.#.#.#.#.#.#.#.###.#.#######.#####.###.###.#######.#####.#.#####.#.###.###.#.###.###.#.#.#########.#######.#.###.#.###########.#.#
#.#...#.#...#.#.#.#...#...#...#.#######.#####.###.###...#####.#####.#.....#.#.#.......#...#.#...#...###...###...###...#...#.#.#######.....#.#
#.#.###.#.#.#.#.#.#.#######.###.#######.#####.###.#####.#####.#####.###.#.#.#.#.#########.#.#.###.#####.#.#####.###.#####.#.#.#######.#####.#
#.#.#...#.....#.#...#.......###.#######.....#.#...#...#.#####.....#.#...#.#.#.#.#.........#.#...........#.#####.....#...#.#.#.#####...#.....#
#.#.#.###.#.###.#####.#########.###########.#.#.###.#.#.#######.#.#.#.#.#.#.#.#.#.#########.#.###########.###########.#.#.#.#.#####.###.#####
#.#.#.#.....###.#####.#########.....#######...#.###.#...#.......#...#.#...#.#.#.#.....#####...#####.....#.............#...#.......#...#.....#
#.#.#.#.###.###.#####.#############.###########.###.###.#.#######.###.#####.#.#.#####.#####.#######.###.###.#####################.###.#####.#
#.#.#.#.###.....#####...#####.....#...#.........#...#.....#.....#.###.....#.#...#####.#.....###.....#...###.###############.....#.#...#...#.#
#.#.#.#.###.###########.#####.###.###.#.#########.###.#####.###.#.#######.#.#########.#.###.###.#####.#.###.###############.###.#.#.###.#.#.#
#...#.#.###.#####.....#.###...###.###.#.....#####.#...#...#.###.#...#####.#.......#...#...#.#...#####.#.....###############.###...#...#.#...#
#####.#.###.#####.###.#.###.#####.###.#####.#####.#.###.#.#.###.###.#####.#######.#.#####.#.#.#######.#####.###############.#####.###.#.#####
###...#.....#.....###...#.....###...#.....#.###...#.....#...###...........#...#...#.#####.#...#.....#...###.###############...#...#...#.....#
###.#####.#.#.###########.###.#####.#####.#.###.#######.#.###########.#####.#.#.###.#####.#.#.#.###.###.###.#################.#.#.#.#.#####.#
#...###.............#.....###.###...###...#.....###.....#.....#####...#####.#.#.....###.....#.#.###.###.#...#...###########...#.....#.###...#
#.#####.#####.###.#.#.#.#####.###.#####.###########.#########.#####.#######.#.#.#######.#####.#.###.###.#.###.#.###########.###.#.###.###.###
#.....#.......###.#.#...#...#.#...#.....#########...#########...###.#######.#...###.....#####.#.###.....#.....#.......#####.#...#...#...#...#
#.###.###.#######.#.#.###.#.#.#.###.#############.#############.###.#######.#######.#########.#.#####.#.###.#########.#####.#.#.#.#.#.#.###.#
#.###...#.###...#.#.#.....#.....#...#.......#.....#...........#.....#...###...#.....#...#####.#.#####.#.....#.......#.###...#...#.#...#...#.#
#.#####.#.###.#.#.#.#######.#####.###.#####.#.#####.#####.###.#####.#.#.#####.#.#####.#.#####.#.#####.#######.#####.#.###.###.#.#.###.###.#.#
#.............#...#...#.....#.....#...#.....#.#####...###.....###.....#.....#.#.#####.#...#.....#####...#####...###.#.###.###.#.#.#...###.#.#
###.#################.#.###.#.#####.#.#.#####.#######.#######.###.#.#######.#.#.#####.###.#.###########.#######.###.#.###.###.#.#.#.#.###.#.#
#...#...###...#.....#...###.#.....#.#.#.....#.........###.....###.#.#.........#.......###...#...........#...###.###.#.....#...#.....#.....#.#
#.###.#.###.#.#.###.#######.###.#.#.#.#####.#.#.#########.#######.#.#.#######.###############.###.#######.#.###.###.#######.#.#.#.###.###.#.#
#.#...#.#...#...#...###...#...#.#...#...###.......#.....#.......#.#.#.........#.....#...#####.#...#######.#.....###.#####...#.............#.#
#.#.###.#.#######.#####.#.###.#.#.###.#.#######.#.#.###.#######.#.#.###########.###.#.#.#####.#.#########.#########.#####.#.###.#.#.###.###.#
#.#...#...#.......###...#.........###.#.....#...#...###...#####.#.#...#####...#.###...#.###...#...#######.........#.......#.#...#.#.#...###.#
#.###.#####.#####.###.#########.#.###.#####.#.###########.#####.#.###.#####.#.#.#######.###.#####.###############.#########.#.#.#.#.#.#####.#
#.#...#####...#.....#...#.......#.#...#...#...###...#...#.#####.#...#.#####.#...............#...#.#########.....#.#########...#...#.#.......#
#.#.#########.#.###.###.#.#######.#.###.#.#######.#.#.#.#.#####.###.#.#####.#########.#######.#.#.#########.###.#.#############.#.#.###.#####
#.#.........#...###...#...###.....#...#.#.........#...#.#...###.......###...###.....#...#.....#.#.....#####.#.....#######...#.....#...#.#####
#.#.#######.###.###.#.#######.#######.#.###############.###.#############.#####.###.#.#.#.#####.#####.#####.#.###########.#.#.#.#####.#.#####
#.#.......#.###.....#.........#######...#...#...###.....###.....###.....#...#...###...#.#.#####.#####.#.....#.......###...#...#.....#.#.#####
#.#.#####.#.#######.#.#######.###########.#.#.#.###.###########.###.###.###.#.#######.#.#.#####.#####.#.#########.#.###.#######.###.#.#.#####
#.#.....#...#.......#.###.....#######.....#...#.....###.......#.###...#.#...#.....#...#...#####.#####.#...###.....#.#...#.....#...#...#.#####
#.#.###.#####.#######.###.###########.#.#.#.#.#####.###.#.###.#.#####.#.#.#######.#.###########.#####.#.#.###.#####.#.###.#.#.#.#.#####.#####
#...###...#.........#.....#...#######...#...#...###...#.#.#...#.###...#.#.#.......#...#.........#.....#.#.....#####.#...#.#...............###
###.#####.#.#####.#.#####.#.#.#######.#.###.###.###.#.#.#.#.#.#.###.###.#.#.#########.#.#####.#.#.#####.###########.###.#.###.#.#.###.###.###
#...#.............#.#...#...#.....#...#.###...#.....#...#...#.#...#.###.#.....#.....#...#####...#.#...#.#...#...###...#.#.#...#.#...#...#...#
#.#.#.#.###########.#.#.#########.#.#.#.#####.#########.#.#.#.###.#.###.#.###.#.###.#############.#.#.#.#.#.#.#.#####.#.#.#.###.###.###.###.#
#.#.#...###.......#...#...#####...#.#.#.#####...#######...#...###.#...#.....#...###.#...###.......#.....#.#...#...#...#.#.......###.....#...#
#.#.###.###.#####.#######.#####.###.#.#.#######.#########.#######.###.#####.#######.#.#.###.#######.#####.#######.#.###.#######.#####.###.#.#
#.....#...#...###.........#...#...#.#...#.....#.#.....###.#...#...#...#####...#.....#.#.....#####...###.....#.....#.###...###.......#...#.#.#
###.#.#.#.###.#############.#.###.#.#####.###.#.#.###.###.#.#.#.###.#########.#.#####.###########.#####.###.#.#####.#####.###.#####.###.#.#.#
#.....#...###.......#.....#.#...#...#.....#...#...#...#...#.#.#.#...#########...#####.....#######.###...###.#...###.#####.....#####.###...#.#
#.#.#.#.###########.#.###.#.###.#####.#####.#######.###.#.#.#.#.#.###################.###.#######.###.#####.###.###.###############.#######.#
#.#...#.....#.......#.###...###.......#####...###...#...#...#...#...#################...........#.#...#####.#...###.#######.........#...###.#
#.#.#.#.###.#.#######.###########.#########.#.###.###.#########.###.###########################.#.#.#.#####.#.#####.#######.#########.#.###.#
#...#...#...#.....#...#####.....#...#######...###.###.........#.#...#.....#####...#.......#####...#.....#...#.#####.#######.#...###...#.....#
#.#.#.#.#.#######.#.#######.###.###.#############.###.#.###.#.#.#.###.###.#####.#.#.#####.#######.#####.#.###.#####.#######.#.#.###.#########
#.............#...#.#######...#.###.......#######.....#.........#...#.###.......#...#####.###...#.........#...#...#.....#.....#.#...#########
###.#.#######.#.###.#########.#.#########.#############.###########.#.###################.###.#.###########.###.#.#####.#.#####.#.###########
###.....#...#.#...#.#####.....#.......###.#.............#######...........###.....#######.....#...#...#####.###.#...###.....###...###########
#####.#.#.#.#.###.#.#####.###########.###.#.#.#.###############.#.###.###.###.###.#######.#######.#.#.#####.###.###.#######.#####.###########
###...#.#.#...###.#.......#...........###.#...#.#####.....#.....#...#.........#...#...#...#######...#.###...#...#...#.......#####.....#######
###.###.#.#######.#.#.###.#.#.###########.#.#.#.#####.###.#.#####.#.###.#######.###.#.#.#.###########.###.#.#.###.###.###########.###.#######
#...###.#...#.....#...#...#.#.........#...#.#...#####.###...###...#.....#######...#.#...#.#######...#...#.#.#...#...#.............###.#######
#.#####.###.#.#########.###.#####.#.#.#.#.#.###.#####.###.#####.#################.#.#####.#######.#.###.#.#.###.###.#####.#.#####.###.#######
#...###.#...#.....#...#.#...#.....#.#.#.#.....#.#####...#.......#############...#.#.#...#.#######.#...#...#.....###.#####.#.....#.###.......#
###.###.#.#.#####.#.#.#.#.###.#####.#.#.#####.#.#######.#####.###############.#.#.#.#.#.#.#######.###.#####.#.#####.#####.#####.#.#########.#
###...#...#...###...#...#...#.#.....#.#...#...#.#.....#.#.......#...###...#...#.#.#.#.#.#...#.....#...#####.#...###...#...#.....#.#.........#
#####.#######.#########.###.#.#.#####.###.#.###.#.###.#.#.#####.#.#.###.#.#.###.#.#.#.#.###.#.#####.#######.###.#####.#.###.#####.#.#########
###...#...#...#####...#.###.#.......#.......#.....#...#...#####...#...#.#.#...#...#...#.#...#.#####...#####.###...#.....###.........#########
###.###.#.#.#######.#.#.###.#######.#####.#.#.#####.#################.#.#.###.#######.#.#.###.#######.#####.#####.#.###.###.#.###.###########
#...#...#...#.......#...#...#.....#.......#.#.#####.......#########...#.#.#...#.....#...#.....###.....#####.#.....#.......#.#.........###...#
#.###.#######.###########.###.###.#########.#.#####.#.###.#########.###.#.#.###.###.#.###########.#########.#.#####.#####.#.#####.###.###.#.#
#.....#.......#########...###...#...........#.#.......#...#########...#.#.#.###...#.#.#.........#...#.......#.....#.#####...#####.###.....#.#
#.#####.###############.#######.#############.#.#######.#.###########.#.#.#.#####.#.#.#.#######.###.#.###########.#.#######.#####.#########.#
#.....#...###...#######...#.....#.............#.........#...#####...#.#.#...#.....#.#.#.#######.#.........#####...#...###...###...#######...#
#####.###.###.#.#########.#.#####.#######.#.###############.#####.#.#.#.#####.#####.#.#.#######.#.#######.#####.#####.###.#####.#.#######.###
#####...#.....#.#######...#...........###.#.............#...###...#...#.....#.....#.#...###...#.#...#...#...###.###...###.#####...#######...#
#######.#######.#######.#####.#######.###.#############.#.#####.#######.###.#####.#.#######.#.#.###.#.#.###.###.###.#####.#######.#########.#
#######.....#...#######...#...........###.###.....#####...#.....#...###.###.......#...###...#...###...#...#...#...#...###.#######.###.......#
#########.#.#.###########.#.#.###.#######.###.###.#######.#.#####.#.###.#####.#######.###.#############.#.###.#.#.###.###.#######.###.#######
#.........#.#.###########...#...#.......#.#...#...#####...#.......#.###.......#######.#...#...#.........#.###...#.###.....#####.............#
#.#########.#.#################.#######.#.#.###.#######.###########.#########.#######.#.###.#.#.#####.###.#####.#.#####.#######.#.#.#######.#
#.....#.....#.#...#############.#.....#.#...#...#####...###...#####.....#####.#####...#.....#...#####.###.#####.#.....#...###...#.#.#.......#
#####.#.###.#.#.#.#############.#.###.#.#####.#######.#####.#.#######.#.#####.#####.###.#############.###.#####.#####.###.###.###.#.#.#.###.#
#...#...........#.#############.#.###...#####.#######.#####.#.....###.........###...#...#...#.....#.......#####.#.....###.....###.#.........#
#.#.#####.#.#####.#############.#.###########.#######.#####.#####.###.###.#######.#.#.###.#.#.###.#.###########.#.###############.#.###.#####
#.........#.#####.#########...#...###.....###...#...#.........#...###.#...#######.#...###.#...#.....#.....###...#.###.....#####...#...#...###
#.#####.###.#####.#########.#.#.#####.###.#####.#.#.#########.#.#.###.#.#########.#.#####.###.#.###.#.###.###.###.###.###.#####.#####.###.###
#...............#.#########...#.......#...#####...#...#######.#.#.....#.#####.....#.#.....###.#.###.#.#.....#...#.....###.#...#.......###...#
#.#.#####.###.#.#.#########.#.#########.#############.#######.#.#.#####.#####.#####.#.#######.#.###.#.#.###.###.#########.#.#.#####.#######.#
#.#.#####.#...#.#.#.......#.#.........#...###########.......#.#.#.#...#.#####.#.....#.#.......#.....#.#...#.###...#######...#.....#.#.....#.#
#.#.#####.#.###.#.#.#####.#.#########.###.#################.#.#.#.#.#.#.#####.#.#####.#.#############.###.#.#####.###############.#.#.###.#.#
#.#.#...........#...#####...#########.###.###...#########...#.......#...#...#.#.......#.#...#######...........###...#####.........#...###.#.#
#.#.#.#.#.#####.#####################.###.###.#.#########.###.#######.#.#.#.#.#.#######.#.#.#######.#########.#####.#####.###############.#.#
#.#...#.#.#.......#####.....#####.......#.#...#.#########.###.#####...#.....#.#.#######...#...#.....#...#...#.....#.#.....#...#######...#.#.#
#.###.#.#.#.#####.#####.###.#####.#####.#.#.###.#########.###.#####.###.###.#.#.#######.#####.#.#####.#.#.#.#####.#.#.#####.#.#######.#.#.#.#
#.....#.#.#...#...#####...#.###...#####.....###.....#.....###...###...#.###...#...#.........#.#.#####.#...#...#...#.#.#...............#.....#
#.###.#.#.###.#.#.#######.#.###.###################.#.#########.#####.#.#########.#.#######.#.#.#####.#######.#.###.#.#.###############.###.#
#.....#...###...#.#######...#...#######...........#...#########.#.....#.#########.#.#...###...#.###...###.....#.###...#.#...#######.....###.#
#.###.#########.#.#########.#.#.#######.#########.#############.#.#####.#########.#.#.#.#######.###.#####.#####.###.###.#.#.#######.#######.#
#.###...........#...#######...........#.###.....#.###...#####...#.......#####.....#...#.###...#...#.....#...###...#.....#.#.#####...#####...#
#.###.#.###.#######.#######.###.#####.#.###.###.#.###.#.#####.###############.#########.###.#.#.#.#####.###.#####.#.#####.#.#####.#######.###
#...........###.....###.....###.....#...###.###.#.....#.#.....#...#.....#.....#########.#...#...#...###.###.......#.#####.#.....#.#.......###
#.###.#####.###.#.#.###.###.###.###.#######.###.#.#####.#.#####.#.#.###.#.#############.#.#########.###.###########.#####.#####.#.#.#########
#.#...#.....#...#.#.....#...###.#.....###...#...#.#####.#.....#.#...###.#.#############.........#...#...###.....###.....#...#.....#.#########
#.#.#.#.#####.###.#######.#####.#.###.###.###.#.#.#####.#####.#.#######.#.#####################.#.###.#.###.###.#######.###.#.###.#.#########
#.#.....#.....#...#.......................................................###############...###...###.#.....#...###...#...............###...#
#.###.###.#####.###.#.###.###########.#.#.###.###.#.#####.#.#####.#######################.#.###.#.###.#.#####.#####.#.###.###.#.###.#.###.#.#
#.........###.....#...#...#.....###...#...#...#...#...#...#...#...#####...###############.....................#...............#.....#.....#.#
###.#########.###.#.#.#.###.###.###.#.#.###.#.#.#.#.#.#.#####.#.#######.#.###############.###.#.###.###.#.#####.#.#.#.###.#.#.#############.#
#...###.....................###.###.#.....#.............................#...###########...#.........#...#.#.....#...#...#...#...###.....###.#
#.#####.#######.#.###.#########.###.#.#.#.#.###.#.###.#####.#.###.#########.###########.###.###.###.#.#.#.#.###########.#####.#.###.###.###.#
#...........#...#...#...#######.....#...#.#.#...#.....#...#.#.......#.......#...###...#.###.....................#.....#...#...#.###.###.#...#
#.#.#.#.#.#.#.#####.###.#############.#.#.#.#.#########.#.#.#####.#.#.#######.#.###.#.#.#######.#.#####.#.#####.#.###.#.#.#.#.#.###.###.#.###
#.#.#.#...#...#...#.......................#.#...#####...#.#.#.......#.........#.....#.#.....#...#.......#...#...#.....#.....#...###.###.#.###
#.#.#.#########.#.#.#.###.#.###.#####.#.#.#.###.#####.###.#.#.###.###################.#####.#.#.###########.#.#######.#.#####.#####.###.#.###
#S..#...........#.....###...###.............###.......###...#.........................#####.....###########...........#.............###...###
#############################################################################################################################################